{
    "tilew": 32,
    "tileh": 32,
    "width" : 20,
    "height" : 15,
    "virtwidth" : 0,
    "virtheight" : 0,
    "objects": [ "wall" ],
    "map" : [
        "W","W","W","W","W","W","W","W","W","W","W","W","W","W","W","W","W","W","W","W",
        "W","W","W","W"," "," "," "," "," "," "," ","W","W","W","W"," "," "," "," ","W",
        "W","W","W","W"," "," "," "," "," "," "," "," ","W","W","W"," "," "," "," ","W",
        "W","W","W","W"," "," "," "," "," "," "," "," "," ","W","W"," "," "," "," ","W",
        "W"," "," "," "," "," "," "," "," "," "," "," "," ","W","W"," "," "," "," ","W",
        "W"," "," "," "," "," "," "," "," "," "," "," "," ","W","W"," "," "," "," ","W",
        "W"," "," "," "," "," "," "," "," "," "," "," "," ","W","W"," "," "," "," ","W",
        "W"," "," "," "," "," "," "," "," "," "," "," "," ","W","W","W","W"," "," ","W",
        "W"," "," "," "," "," "," ","W","W","W","W"," "," ","W","W","W","W"," "," ","W",
        "W"," "," "," "," "," "," ","W","W","W","W"," "," "," "," "," "," "," "," ","W",
        "W"," "," "," "," "," "," ","W","W"," "," "," "," "," "," "," "," "," "," ","W",
        "W"," "," "," "," "," ","W","W","W"," "," "," "," "," "," "," "," "," "," ","W",
        "W"," "," "," "," ","W","W","W","W"," "," "," "," "," ","W"," "," "," "," ","W",
        "W"," "," "," ","W","W","W","W","W"," "," "," "," ","W","W","W"," "," "," ","W",
        "W","W","W","W","W","W","W","W","W","W","W","W","W","W","W","W","W","W","W","W"
    ],

    "alias" : {
        "W" : "wall",
        " " : -1
    }
}
