{
    "tilew": 32,
    "tileh": 32,
    "width" : 20,
    "height" : 15,
    "virtwidth" : 0,
    "virtheight" : 0,
    "objects": [ "wall", "box" ],
    "map" : [
        "W","W","W","W","W","W","W","W","W","W","W","W","W","W","W","W","W","W","W","W",
        "W"," "," "," "," "," "," "," "," "," "," "," "," "," "," "," "," "," "," ","W",
        "W"," "," "," "," "," "," "," "," "," "," "," "," "," "," "," "," "," "," ","W",
        "W"," "," "," "," "," "," "," "," "," "," "," "," "," "," "," "," "," "," ","W",
        "W"," "," ","W","W"," "," "," "," "," ","W","W","W"," "," "," "," "," "," ","W",
        "W"," ","W"," "," "," "," "," ","B"," "," "," "," "," "," "," "," "," "," ","W",
        "W"," "," "," "," "," "," ","B","B"," "," "," ","W","W","W","W","W","W"," ","W",
        "W","W"," "," "," "," ","B","B","B","B"," "," "," "," "," "," "," "," "," ","W",
        "W"," "," "," "," ","B","B","B","B","B"," "," "," "," "," "," "," "," "," ","W",
        "W","W"," ","W","W","W","W","W","W","W","W"," "," "," "," "," ","W","W","W","W",
        "W","W"," "," "," "," "," "," "," "," "," ","W"," "," "," "," ","W","W","W","W",
        "W","W","W"," "," "," "," "," "," "," "," ","W","W"," "," "," ","W","W","W","W",
        "W","W","W"," "," "," ","W"," "," "," "," "," "," "," ","W","W","W","W","W","W",
        "W","W","W","W"," ","W","W","W"," "," "," "," "," "," ","W","W","W","W","W","W",
        "W","W","W","W","W","W","W","W","W","W","W","W","W","W","W","W","W","W","W","W"
    ],
    "alias" : {
        "W" : "wall",
        "B" : "box",
        " " : -1
    }
}
